   ##  #
E#  ## #
 # -   #
## # ###
#S## ###
#    ###
#  #####