       #
 #  ## #
 # #   #
## # ###
#S##  ##
# ### ##
#     ##
  ######