   ##  #
E#  ## #
 #     #
## # ##
#S## ###
#    ###
#  #####
##   ###