       #
 #  ## #
 # #   E
## # ###
# ##  ##
# ###   
#     # 
########