      E#
 #  ## #
 #     #
## # ###
#S##  ##
# ### ##
#     ##
E ######