       #
 #  ## #
S# #    
## #E## 
# ##  # 
# ### # 
#     # 
S ####  