       #
 #  ## #
S# #    
## # ## 
# ##  # 
# ### # 
#     # 
S ####  