-----#---------------
-###-#-#-###########-
---#---#---#S--------
##-#######-###-######
---#-----#---#-#-----
-###-###-#-#-#-#-###-
-#---#-#-#-#-#-#-#---
##-###-#-###-#-###-##
---#---#-----#---#---
-###-###########-###-
-----#---------------
###-###--##--##-#E###
