       #       
 # ### # ##### 
 # #S  #     # 
 # ##### ##### 
 #       #     
 #### ##E###   
