 # # # # # # # # # #S
#####################
 # # # # # # # # # # 
#####################
 # # # # # # # # # # 
#####################
 # # # # # # # # # # 
#####################
 # # # # # # # # # # 
#####################
 # # # # # # # # # # 
#####################
 # # # # # # # # # # 
#####################
 # # # # # # # # # # 
#####################
 # # # # # # # # # # 
#####################
 # # # # # # # # # # 
#####################
 # # # # # # # # # # 
