             #   #   #                     #   #S  #               #                   #            
 # ######### # # # # # ############# ##### # # ### # ##### ####### ######### ######### ### #######  
 # #       # # # # # # #           #     #   #     # #   # #               # #       #   # #     # #
 # ##### # # # # ### # ### ####### ##### ####### ### ### # ############### # # ##### ### ### ### # #
 #     # #     #   # # #   # #   #     #   #     #   #   # #     #         # # #   # #       # # # #
 ##### ########### # # # ### # # ### ##### ####### ### # # # ### ##### ##### # ### # ######### # # #
 # #   #         #   # # # #   #     #   # #       #   # #     # #   # #   #       #     #       # #
 # # ### ####### ##### # # # ######### # # # ####### ########### # # # # # # ########### # ####### #
 # #   # #     #     #   #   # #     # #   #   #     #     #   #   # #   # # #           #         #
 # ### # # # # ##### ##### ### # # ### # ##### ##### # ### # # ##### ##### # # ##### ##### ######## 
 #   #   # # # #         # #     # #   # #     #     #   #   #     #   #   # #     # #   # #        
 # # ##### # ### ##### ### # ##### # ##### ##### ####### ### ##### ### # ######### # # # ### ##### #
   # #     #   # #     #   #   #   #   #   #   # #       #   #   #     #   #   #   # # #     #   # #
#### # ####### # ####### ##### # # ### # ### # # # ##### ##### # ######### # # # ### # ####### # # #
 #   #       # #         # #   # #   # #     # # #     # #     #     # #     #   #   #   #     # #  
 # ##### ##### ########### # ### ##### ####### # ##### ### ######### # # ########### ### ##### # #  
   #   # #   #                 #   #         #       #   #   #   #   #     #   #   #   #   #   # #  
 ### # # # # ### ################# # ####### ####### ### ### ### # ### ##### # # # ### ### # ##### #
 #   #   # #   #   #     #       # # #       #     #   #   #   # # #   #     #   #   #   # #   #    
 ##### ### ### ##### ### # ##### # # ##### ##### # ### ### ### # # # ### ########### ### # ### # #  
     # #   # #     # #   # #   #   #     #       #   #   #   # # # #   # #         #   # # #   # # #
#### ### ### ##### # # ### # # ### ##### # ####### ##### ### # # # ##### ####### # ### # # # # # #  
     #   #           #   # # #   #   # # # #     # #   # # # # # #       #   #   # #   # #   # # #  
 ##### ### ############# # ### # ### # # ### ### ### # # # # # # ######### # # ### # ######### # # #
 #       # #         #   #   # # #   # # #   # # #   #     # # #       #   # #   # # #         # #  
 # ##### # # ####### ### ### # # # ### # # ### # # ######### # ### # ### # # ### ### # ######### ###
 # #     # # #     #   #   # # # # #   #   #   #   #   #   # #   # # #   # #   #   # #     #   #   #
 # # ####### # # ##### ### # # # # # ######### ##### # # # # ### ### # ### ### ### # ##### ### ### #
 # #       #   # #     # # # # # # #         #       # # #     # #   # #   # #     #   #       #   #
 # ####### ##### # ##### # # ### # ####### # ### # ##### ### ### # ### # ### ### ##### # ####### ###
 #     #   #     # #   #   #   #         # #   # # #   # #   #   #     # #     # #   #   #     #   #
 ##### # ### ##### ### # ### # ######### # ### # ### # # ##### ### ##### # # ### # # ##### ### ### #
   #   #         #   # # #   #     #   # # # # #     # #       #     #   # # #   # #   #   # #   # #
## ### ############# # # ######### # ### # # # # ##### ######### ##### ### # # ### ### # ### ### # #
 #   #     #     #   #         #   # #   # #   # #     #   #   # #     #   # #   # #   # #     # #  
 ### ##### # ### # ########### # ### # ### # ##### ### # # ### # # ##### # ##### # ### # ### # # # #
     #   # # #   #     #     #   #   #     # #     # #   #   #   # # #   #       #   # # #   # # #  
 ##### # ### # ####### # # # ##### ######### # ##### ####### ##### # # ############# # # # ##### #  
       # #   #       # # # #     #       #   #     #   #   #       #   #       #     #   # #     # #
######## # ######### # # # ####### ##### # ####### # ### # # ####### ### ##### # ######### # #####  
       # # #   #     # # # #       #   #   #       #     #   #     #   #   #   #     #       #     #
 ### # # # # # # ##### ### # ####### # ####### ##### ######### ### # ##### ### ##### # ####### ### #
   # # #   # # #   #     #         # #         #   # #       # #   # #   #   #   #   # #     #   # #
## # ####### ##### ##### # ####### ######### ### ### ### # ### # ##### # # # ### # ### # ### ### #  
 # #     #         #   # # #     #           #       #   # #   # #     # # #   #   #   #   #     #  
 # ##### # ######### # # # # ### ############# ####### ##### ### ### ### # ### ##### ######### ### #
 #   #   # #     #   #   # # #   #             #       #     # #     #   # #   # #   #       #   # #
 ### # ### ### # # ##### ### # ####### ######### ####### ##### ####### ### # ### # ### ##### ### # #
     #   # #   #   # #   #   #   #   #         # #       #       #   # #   #   #   #   #     #   #  
 ####### # # ####### # ### ##### # # ######### # # # ##### # # ### # # ####### # ### ####### #####  
 #     #   #   #     # #   #     # # #   #       # # #   # # # #   # # #       # #         # #     #
 # ### ####### # ### # # ### ##### # # # # ####### # # # # # # # ### # # ####### # ####### # # ###  
   #           #   #   # #         #   # # # #     # # # # # # # # #   #     # # # #       # # #    
 ######### ####### ##### ############### # # # ####### # # # # # # ##### ### # # ### ####### # # ###
 #     #   #   #       #   #   #   #     #   #         # # # # #   #       # # # #   #     #   #    
 # ### ##### # ########### # # # # # ####### ####### ### # # ##### # ####### # # # ##### # ####### #
 #   #       #             # #   #   #     #   #   #   # # #     # # #       # # #     # #     #    
 ### ##### ################# ########### # ##### # ##### ##### ### ### ####### # ##### ##### # # ###
 # # #   # #   #   #       # #           #   #   # #     #   #   #   # #   #   #       #   # #   # #
 # # # ### # # ### # ### ### # ####### ##### # ### # ##### # ### ### # # # # ######### # # # #####  
   # # #   # #   # #   #   # # #       #   #   # # #   #   # #   #   #   # #       #   # # #   #    
#### # # ### ### # ### ### # # # ####### # ##### # # # # ### # # # ### ### # ##### # ### # ### ### #
     #   #   #   #   #   # # # # # #   # #     #   # # #   #   # #   #   # # #   #   #   #   #   # #
 ######### ######### ### # # # # # # # # ##### # ##### # # ##### ### ### # # # # ##### ##### ### # #
           #       #   # # # # # #   # # #   #   #     # # #       #   # # #   # #     # #   # # # #
################ # ### # # # # # # ### # # # ##### ##### # ########### ### ####### ##### # ### # # #
   #             #   # # #   # # #   #   # #   #   # #   # #         #   #               # #   #   #
 # ##### # ### ##### # # ##### # ##### ### ### # ### # ### # ####### ### # ############# # # # ###  
 #     # # #   #   #   # #     #     #     # # #   #     # # #     #     # #     #       # # #      
 ##### ### # ### # ##### ### ####### ####### # # # ####### # ### ########### ### # ####### # #######
 # #   #   #   # #     #   #       # # #     # # #       # #   #             #   #       # # #     #
 # # ### ##### # ##### ### ### ##### # # # ### ######### # ### # ##### ####### ##### ##### # # ### #
 #   #   # #   #     # #   # # #     #   #               #   # # #     #           # #     # # # #  
 ### ### # # ##### ### # ### # # ### ####################### # ### ############### ### ##### # # # #
   # #   #     #   #   # #     # #   #       #     #         #   #     #     #         #   #   #    
 # # # ######### ### ### ####### ##### ##### # ##### ### ####### ##### # ### ########### # ##### ###
 # #   #         # #   #       #   #   # #   # #   #   #       # #     # # # #     #     # #   #   #
 # ##### ######### ### ####### ### # ### # ### # # ### ####### # # ##### # # # ### # ##### # # ### #
 #     # #     #     #       #   #       # #     #     #     # # #         # #   #   # #   # # #   #
 ##### # # ### ### # ####### ### # ####### # ############### # # ########### ### ##### # ### # #####
   # #   #   #     #       #     # #       # #             # # # #             #   #   #     #      
## # ####### ############# ######### ####### ####### ##### # # # # ##### ######### ### ###########  
 # #   #     # #       # #     #     # #       #     #   # # #   #     # #   #   #   #     #        
 # # ### # ### # ### # # ##### # ##### # ##### # ##### ### # ##### ### # # # # # ### # ### # ##### #
 # #     #   #   #   #       # #   #     #   # # #       #   #   # # # # # #   #     # #   #     #  
 # ######### # ### ########### # # ##### # # # # ####### ### # ### # # ### ############# # ##### # #
 #       #   #   # #         # # #     # # # # #       #   # #   #   #   #   #           # #   # #  
 ####### # ####### # ####### # # ##### ### # # ####### # # # # # ### ### ### # ##### ##### # # # #  
 #     #   #     # # #     #   #     #   # # #     #   # # # # #   #   #   # # #     #   # # # # #  
 # # # ##### # # # # ### # ######### ### # # ##### # ### ### ### # ### ### # ### ##### ### # # # ###
   # #   #   # #   # #   # #     #     # # #   #   #   # #   #   # #   # # #     #           # #    
 ### ### # ### ##### # ### ### # ####### # ### ### ### # # ### ### # ### # ### ############### ###  
   # #   # # #   #   # #   #   #       # #   #   #     # # # #   # #   # #     #   #         #   # #
## # ### # # ### # ### # ### ######### # ### ### ####### # # # # ##### # ####### # # ####### ##### #
   #   # #   # #   #   #     #     #   #       #     #   # #   #               # # # #     #       #
 ##### ##### # ####### ####### ##### ########### ### # # # ################# ### # # # ###########  
 #   # #   #   #     #       # #   #       #   #   # # # #               #   #   # # # #       #    
 ### # # # ### # ### ####### # # # ####### # # ##### # ################# ##### ### # # # ##### # ###
     #   #       #           #   #           #       #                         #     #       #      
###  #  ###  ### # ### #  ########### #   ####      #####     #  #  #  ##   ## ### #  # ###E##    ##
