         #S#         
 # ##### # # # ##### 
 #   #     # #   #   
 ### ####### ### # ##
   #   #     #   #   
###### # ##### ######
     # # #   #       
 ### # # # # ####### 
 #   #   # #         
 ### ##### ######### 
   #       #     # # 
 # ######### ### # # 
 #           #   #   
###          # ###E##
